111111111111111111111111111111111
11111111ww11111111111111111111111
111111100001111111111111111111111
1111111P0000000111111100001111111
111111100000000111111000000111111
0000000110000001111000M0000111111
000000001111111111000000000011111
0000M000000B0C0000000000000011111
000000000001000C00000000000001111
11100000000110000000000B000000111
11111100001111100000000000000000w
11111110000011100000C000000011111
11111110B000111000000000001111111
111111100000011100111111111111111
111111000H00011111111111111111111
111111100000111111111111111111111
111111110001111111111111111111111
