111111111111111111111111111111111
1111111q000000000000B000000111111
000011100000011111111111100011111
000011000111111111111111110011111
0000110001111100000C0000110001111
V00011000110000111111100110001111
11001100011000000000S100110000111
e00011000110111111111110111000011
e00011000011100000000000011000011
110011000000000M00000000011000011
000M1111110001111111111111100000q
111011111111111111111111111000011
11101100000000000000000B000001111
000010000000000000000000000011111
001110001111111111111111111111111
000000001111111111111111111111111
111111111111111111111111111111111
