000000011111111111111111111111111
000000000111111111111111111111111
000000000000001111111111111111111
000000000000000001111111111111111
000000000000000000000011111111111
000000000000000000000000111111111
000000000000000000000000000000000
000000000000000000000000000000000
000000000000000000000000000000000
000000000000000000000000000000000
000000000000000000000000000000000
000000000000000000000000111111111
000000000000000000000011111111111
000000000000000001111111111111111
000000000000001111111111111111111
000000000111111111111111111111111
000000011111111111111111111111111
