111111111111111111111111111111111
111111111111111111111111111111111
111111111111111111111111111111111
111111111111111111111111111111111
111111111111111111111111111111111
1111111H00000000B000000H111111111
111111111111000000000000H00000001
w0000000000000000000000000000000r
w00000000000000H000000000000M000r
11111111100000000000000000000000r
11111111H000000000000000000000001
111111111111111000000H00111111111
111111111111111111111111111111111
111111111111111111111111111111111
111111111111111111111111111111111
111111111111111111111111111111111
111111111111111111111111111111111
