111111111111111111111111111111111
111111111111111111111111111111111
111111111111111111111111111111111
111111111111111111111111111111111
111111111111111111111111111111111
1111111000000000B0000000111111111
111111111111000000000000000000001
w0000000000000000000000000000000r
w000000000000000000000000000M000r
11111111100000000000000000000000r
111111110000000000000000000000001
111111111111111000000000111111111
111111111111111111111111111111111
111111111111111111111111111111111
111111111111111111111111111111111
111111111111111111111111111111111
111111111111111111111111111111111
