000000000000000000000000000000000
000000000000000100000000000000000
000000000000000100000000330000000
000000000000000100000000000000000
000000000000000111111111111111101
000000000000000100000000000000000
000000000000000000000000000000000
000000000000000000000000000000000
000000000000000000000000000000121
000000000000000000000000000000000
000000000000000000000000000000000
000000000000000000000000000000000
000000111111111111111000000000000
000000000000000000000000000000000
000000000000000000000000000000000
000000000000000000000000000000000
000000000000000000000000000000000
