111111111111111111111111111111111
111111111111111111111111111111111
111111111111111111111111111111111
111111111111111111111111111111111
111111111111111111111111111111111
1111111V00000000B0000000111111111
111111111111000000000000000000001
w0000000000000000000000000000000r
w00000000000000H000000000000M000r
11111111100000000000000000000000r
11111111V000000000000000000000001
111111111111111000000V00111111111
111111111111111111111111111111111
111111111111111111111111111111111
111111111111111111111111111111111
111111111111111111111111111111111
111111111111111111111111111111111
