111111111111111111111111111111111
111111111111111111111111111111111
111111111111111111111111111111111
111111110000000000000000000001111
111111110000000000000000000001111
111110000001100011000000000001111
000000000001100011000000000001111
r00000000000000000000000000001111
r0000000000000000000000K000001111
r00000000000000000000000000001111
000000000001100011000000000001111
111110000001100011000000000001111
111111110000000000000000000001111
111111110000000000000000000001111
111111111111111111111111111111111
111111111111111111111111111111111
111111111111111111111111111111111
