111111111111111111111111111111111
111111111111111111111111111111111
111111111111111111111111111111111
111111111111111111111111111111111
111111110000000000000000000001111
111110000000000000000000000001111
000000000000000000000000000001111
000000000000000000000000000001111
000000000000000000000000000001111
000000000000000000000000000001111
000000000000000000000000000001111
000000000000000000000000000001111
000000000000000000000000000001111
111111111111111111111111111111111
111111111111111111111111111111111
111111111111111111111111111111111
111111111111111111111111111111111
